to take in|acoger
to contribute|aportar
to support|apoyar
to risk (oneself)|arriesgarse
the political asylum|el asilo político
the boom|el auge
to look for|buscar
to report|denunciar
the human rights|los derechos humanos
adrift|a la deriva
the collapse|el derrumbe
to waste|despilfarrar
the boat (starts with e)|la embarcación
to push|empujar
to enrich|enriquecer
the lack (starts with e)|la escasez
to choose (starts with e)|escoger
the hope|la esperanza
the foreigner|el extranjero
the brain drain|la fuga de cerebros
to earn a living (3 words)|ganarse la vida
to need (2 words 1st word starts with h)|hacer falta
to find (starts with h)|hallar
the hospitality sector|la hostelería
the equality|la igualdad
the illegal immigrant|el inmigrante irregular
to retire|jubilarse
the workforce|la mano de obra
to provide for|mantener a
to leave (starts with m)|marcharse
the black market|el mercado sumergido
to suffer (starts with p)|padecer
to pay taxes|pagar impuestos
a host country|un país receptor
the small boat|la patera
the work permit|el permiso de trabajo
the residency permit|el permiso de residencia
to head to (3 words)|poner rumbo a
the spokesman|el portavoz
the spokeswoman|la portavoz
coming from (2 words 2nd word is de)|procedente de
to take away (starts with q)|quitar
to carry out|realizar
to take refuge|refugiarse
the refugee (male)|el refugiado
the refugee (female)|la refugiada
to return (starts with reg)|regresar
to rescue|rescatar
the social security|la seguridad social
to survive|sobrevivir
the birth rate (4 words)|la tasa de natalidad
to relocate/to move (starts with t)|trasladarse
the wall/border (starts with v)|la valla
despite|a pesar de
to have just (done something)|acabar de
to show gratitude for|agradecer
to feed|alimentar
to yearn|anhelar
the ancestry|la ascendencia
the quality of life (1st word starts with c)|la calidad de vida
to change|cambiar
the census|el censo
the citizenship|la ciudadanía
the colonies|las colonias
to share|compartir
to live with|convivir
to grow up (also "to grow")|crecer
to leave (starts with d)|dejar
the destination|el destino
to spread (starts with d)|difundir
to head (starts with d also "to lead")|dirigir
the stability|la estabilidad
to break out|estallar
the lack of (starts with f)|la falta de
the training (starts with f)|la formación
to earn (starts with g)|ganar
the war (starts with g not "guerra")|la guerrilla
the hunger|el hambre
to flee (starts with h)|huir
to increase (starts with i)|incrementar
the links with|los lazos con
the freedom|la libertad
to make ends meet|llegar a fin de mes
to fight (starts with L)|luchar
to improve|mejorar
the spanish-speaking world|el mundo hispánico
to be born|nacer
wave/surge/flood of (3 words starts with o)|la oleada de
to stay (starts with p)|permanecer
to try your luck|probar suerte
the post/position|el puesto
to strengthen/to reinforce|reforzar
to live (starts with r)|residir
to return (starts with ret)|retornar
the Castro revolution|la revolución castrista
the wealth|la riqueza
to save (starts with s)|salvar
to carry on/to follow|seguir
to highlight (starts with s)|señalar
the European Union|la Unión Europea
to travel (starts with v)|viajar
to camp out|acampar
to accept/to embrace|acoger
to go deep into|adentrar
to drown|ahogarse
to arrest (starts with a)|apresar
the support|el arraigo
the arrival|el arribo
the legal advice|el asesoramiento jurídico
native (starts with a)|autóctono
to help (starts with au)|auxiliar
caer|to fall
the refugee centre|el centro de asistencia
to get (starts with c)|conseguir
the smuggler|el contrabandista
to cross|cruzar
to look after|cuidar
to deport|deportar
the rights|los derechos
to discover|descubrir
to arrest (starts with d)|detener
to register|empadronar
to head/to lead (starts with e)|encabezar
the straits (of gibraltar)|el estrecho
to avoid (starts with eva)|evadir
to die (starts with f)|fallecer
to sign|firmar
the civil servant (male)|el funcionario
the civil servant (female)|la funcionaria
to hit|golpear
to shout|gritar
injured person (male)|el herido
injured person (female)|la herida
to sink|hundir
the immigrants without any documents/papers|los indocumentados
to enter (starts with i)|ingresar
to invest|invertir
to achieve (starts with L)|lograr
nevertheless|no obstante
western|occidental
to pay|pagar
the native population|la población autóctona
the poverty|la pobreza
the policy (or the politics)|la política
to start, to set in motion (3 words)|poner en marcha
the press|la prensa
GDP|el producto interior bruto
to resort to|recurrir
to legalise (starts with r)|regularizar
the remittances|las remesas
the risk|el riesgo
the survivor|el sobreviviente
suspicious|sospechoso
the rate of|la tasa de
to land (2 words 1st word starts with t)|tocar tierra
the trafficker|el traficante
to process (paperwork)|tramitar
to carry (starts with t)|transportar
to move (starts with t)|trasladar
the treatment/the agreement|el trato
the journey (starts with trav)|la travesía
the journey (starts with tray)|el trayecto
the threshold|el umbral
to get together (starts with u)|unirse
