to get on with (2 words) + case|auskommen mit + dative
to look like, to appear + case|aussehen + nominative
both|beide
to describe + case|beschreiben + accusative
certainly (starts with b)|bestimmt
the cousin (male)|der Cousin (-s)
the cousin (female)|die Cousine (-n)
the family|die Familie (-n)
the woman, wife|die Frau (-en)
the girlfriend, friend who just so happens to be a girl|die Freundin (-nen)
to give (the direct object) + case|geben + accusative
to give (to the indirect object) + case|geben + dative
to like, to please + case|gefallen + dative
the community, group|die Gemeinschaft (-en)
the present, gift|das Geschenk (-e)
divorced|geschieden
there is/there are|es gibt
to be lucky|Glück haben
happy|glücklich
the grandparents|die Großeltern
the grandmother|dieGroßmutter (¨)
the grandfather|der Großvater (¨)
each, every|jeder, jede, jedes
single, unmarried (starts with L)|ledig
loving, affectionate|liebevoll
the morning|der Morgen
to get on one's nerves (4 words)|auf die Nerven gehen
the grandma|die Oma (-s)
the uncle|der Onkel (-)
the grandpa|der Opa (-s)
the partner (male)|der Partner (-)
the partner (female)|die Partnerin (-nen)
the person|die Person (-en)
the town|die Stadt (-¨e)
the step brother|der Stiefbruder (¨)
the stepmother|der Stiefmutter (¨)
the stepsister|die Stiefschwester (-n)
the stepfather|die Stiefvater (¨)
the aunt|die Tante (-n)
the pocket money|das Taschengeld (-er)
the relationship|das Verhältnis (-se)
married|verheiratet
engaged (to someone)|verlobt
get on with (reflexive)|sich verstehen mit
to call in, drop by|vorbeikommen
the widow|die Witwe (-n)
to live, reside|wohnen
three (of us)|zu dritt
together|zusammen